..........................
..........................
..##..##..##..##..##..##..
..##..##..##..##..##..##..
..##..##..##..##..##..##..
..##..##..##..##..##..##..
..##..##..##@@##..##..##..
..##..##..##@@##..##..##..
..##..##..##..##..##..##..
..##..##..........##..##..
..##..##..........##..##..
..........##..##..........
..........##..##..........
##..####..........####..##
##..####..........####..##
..........................
............@@............
..##..##....@@....##..##..
..##..##..........##..##..
..##..##..........##..##..
..######..........######..
..........................
..........................
...........####...........
...........@..@...........
...........@..@...........