........####..............
........####..............
........##......@@@@@@....
@@..##..##..........@@....
@@..##......##............
@@..##......##............
##..######..####..####..##
##..######..####..####..##
##......##........##......
..................##......
........%%%%..%%%%%%..####
....##..%%%%..%%%%%%..####
####....%%##..###.........
####....%%##..###.........
........%%...........@@...
........%%...........@@...
~~~~~~..%%..@@..##...@....
~~~~~~..%%..@@..##...@....
.....................@####
......####...........@####
........##########........
........##......####......
######............####....
####.......####.....##....
##.........#..#...........
...........#..#...........